Tootsie.	#Dustin Hoffman, Jessica Lange, Teri Garr,...	#Alan Grint	#Todos los p�blicos
Diez negritos.	#Oliver Reed, Elke Sommer, Richard Attemborough,...	#Abbas Kirostami	#No recomendado a menores de 13 a�os
Volver a casa.	#Joely Richardson, Gary Oldman, Stephen Dillane,...	#Alan Parker.	#No recomendado a menores de 13 a�os
Las aventuras de Pinocho.	#Martin Landau, Jonathan Taylor Thomas....	#Albert y Allen Hughes.	#Sin clasificar
Dinosaurios.	#Omri Katz, Shawn Hoffman, Tiffanie Poston,...	#Bernard Rose.	#Todos los p�blicos
Gaby, una historia verdadera.	#Rachel Levin, Liv Ullman, Norma Aleandro,...	#Alan Parker.	#Todos los p�blicos
Anna Karenina.	#Sophie Marceau, Sean Bean, Alfred Molina,...	#Alan Parker.	#No recomendado a menores de 13 a�os
Aventuras en la corte del rey Arturo.	#Thomas Ian Nicholas, Joss Ackland, Art Malik,...	#Bernard Rose.	#Todos los p�blicos
Mohawk.	#Scott Brady, Rita Gam, Neville Brand, ...	#Al Waxman.	#Todos los p�blicos
Dos tontos muy tontos.	#Jim Carrey, Jeff Daniels, Lauren Holly,...	#Alan Grint	#Todos los p�blicos
Starlight.	#Kario Salem, Jean Taylor, Pamela, Payton-Wright 	#Alex Cox.	#Todos los p�blicos
Esp�as sin fronteras.	#Gene Hackman, Mikhail Barisnikhov, Kurtwood Smith.	#Abbas Kirostami	#No recomendado a menores de 13 a�os
Bwana.	#Andr�s Pajares, Mar�a Barranco, Emilio Buale.	#Alan Parker.	#No recomendado a menores de 13 a�os
A por el oro.	#James Ryan, Mzwandile Ngxangane, Sandra Horne, Cameron Mitchell	#Albert y Allen Hughes.	#Todos los p�blicos
Austin Powers	#Mike Myers, Elizabeth Hurley, Michael York, Mimi Rogers.	#Alan Grint	#Todos los p�blicos
La red.	#Sandra Bullock, Jeremy Northam, Dennis Miller, Diane Baker	#Abbas Kirostami	#No recomendado a menores de 13 a�os
Tensa espera.	#Susan Sarandon, Sam Shepard, Sean Astin, Robert Sean Leonard	#Alan Parker.	#No recomendado a menores de 13 a�os
Hairspray.	#Sonny Bono, Ruth Brown, Mabel Divine, Colleen Fitzpatrick	#Alan Grint	#No recomendado a menores de 13 a�os
Un verano junto al mar.	#Kerstin Draeger, Heikko Deutschmann, Ruth Mar�a...	#Alan Parker.	#Todos los p�blicos
Su juguete preferido.	#Richard Pryor, Jackie Gleason.	#Alan Grint	#Todos los p�blicos
Vaya par de idiotas.	#Woody Harrelson, Randy Quaid, Bill Murray,....	#Alan Grint	#Todos los p�blicos
Dos por el precio de una.	#Kirstie Alley, Steve Guttenberg, Mary K. Olsen,...	#Alan Grint	#Todos los p�blicos
Un loco a domicilio.	#Jim Carrey, Matthrew Broderick, George Segal,...	#Alan Grint	#Sin clasificar
Star Trek.	#William Shatner, Leonard Nimoy,...	#Alfonso Ungr�a	#Todos los p�blicos
Misi�n imposible.	#Peter Graves, Barbara Bain,...	#Alex de la Iglesia.	#Todos los p�blicos
Rosa Rosae	#Ana B�len, Mar�a Barranco, Juanjo Puigcorbe,...	#Alan Grint	#Sin clasificar
A galope	#R. G. Armstrong, Lloyd Bridges, Lonny Chapman, Pat Hingle.	#Alan Parker.	#Todos los p�blicos
Velocidad terminal	#Charlie Sheen, Natassja Kinski, ....	#Barry Sonnenfeld.	#Sin clasificar
Hellbound: Hellraiser II.	#Clare Higgins, Ashley Laurence,....	#Betty Kaplan.	#Sin clasificar
El fantasma de la  �pera.	#Maximiliam Schell, Jane Seymour,...	#Alan Parker.	#Sin clasificar
Doble venganza.	#Leigh McCloskey, Joe Dallesandro,...	#Bernard Rose.	#Sin clasificar
Halcones de mar.	#Rob Lowe, Gale Hansen, Tracy Griffith,...	#Alan Parker.	#Sin clasificar
Un casino en el espacio.	#Matthew Barton, Jennifer Blowdryer, John Canalli,-	#Alan Birkinshaw.	#Sin clasificar
Dos d�as en el valle.	#Danny Aiello, Greg Cruttwell, ...	#Abbas Kirostami	#Sin clasificar
Creepshow.	#Hal Holbrood, Leslie Nielsen, Ed Harris,...	#Betty Kaplan.	#Sin clasificar
Estoy vivo.	#John P. Ryan, Sharon Farrell, James Dixon,...	#Betty Kaplan.	#Sin clasificar
Syngenor, el soldado del futuro.	#Starr Andreeft, Lewis Arquette, ...	#Alan Birkinshaw.	#Sin clasificar
Doce del pat�bulo.	#Lee Marvin, Charles Bronson, Telly Savalas,...	#Billy Wilder.	#Sin clasificar
Secuestrada.	#Goldie Hawn, John Heard, Ashley Peldon,...	#Abbas Kirostami	#Sin clasificar
El dentista.	#Corbin Bernsen, Linda Hoffman, Molly Hagan,...	#Albert y Allen Hughes.	#Sin clasificar
Henry: retrato de un asesino.	#Michael Rooker, Tom Towles, Tracy Arnold,...	#Abbas Kirostami	#Sin clasificar
Warlock, el brujo.	#Julian Sands, Lori Singer, Richard E, Grant,...	#Betty Kaplan.	#Sin clasificar
Han llegado.	#Charlie Sheen, Lindsay Crouse, Roichard Schiff,...	#Alan Birkinshaw.	#Sin clasificar
Angel of desire.	#Melanie Hudson, Nathan Leonard.	#Barry Sonnenfeld.	#No recomendado a menores de 18 a�os
Tibur�n: La venganza	#Lance Guest, Mario Van Peebles, Karen Young.	#Alan Parker.	#No recomendado a menores de 13 a�os
El coraz�n del �ngel.	#Mickey Rourke, Robert De Niro, Lisa Bonet.	#Betty Kaplan.	#No recomendado a menores de 18 a�os
Highlander.	#Christopher Lambert, Sean Connery, Roxanne Hart.	#Barry Sonnenfeld.	#No recomendado a menores de 13 a�os
Monta�a rusa.	#George Segal, Richard Widmark,Henry Fonda.	#Abbas Kirostami	#No recomendado a menores de 7 a�os
Frankenstein.	#Boris Karloff, Colin Clive, Mae Clarks.	#Betty Kaplan.	#No recomendado a menores de 7 a�os
Creemos en el amor.	#Clifton Webb, Dorothy Mcguire, Jean Peters; Louis jourdan, Maggie Mcnamara, Rossano Brazzi.	#Alan Parker.	#Todos los p�blicos
El coleccionista	#Terence Stamp, Samantha Eggar, Maurice Dellimore.	#Abbas Kirostami	#No recomendado a menores de 13 a�os
Un verano para matar	#Christopher Mitchum, Karl Malden, Olivia Hussey, Raf Vallone, Claudine Anger	#Abbas Kirostami	#No recomendado a menores de 13 a�os
A trav�s de los olivos.	#Mohamad Ali Keshavarz, Farhad Khradmand, Zarifeh Shiva, Hossein Rezai.	#Alan Parker.	#No recomendado a menores de 13 a�os
El contrato del dibujante.	#Anthony Higgins, Janet Suzman, Anne Louise Lambert.	#Alan J. Levi.	#No recomendado a menores de 13 a�os
El d�a de las idiotas	#Carole Bouquet, Ingrid Caven, Ida Di Benedetto, Tamara Kafka	#Alan Parker.	#Sin clasificar
Vertical features remakes.	#M�sica: Michael Nyman.	#Alan J. Levi.	#No recomendado a menores de 13 a�os
Un hombre llamado Peter	#Richard Todd, Jean Peters, Robert Burton, Marjorie Rambeau, Jill Esmond, Mimi Hutson	#Alan Parker.	#No recomendado a menores de 13 a�os
Vanya en la calle 42.	#Wallace Shawn, Brooke Smith, Julianne Moore, George Gaynes, Andr� Gregory.	#Alan Parker.	#Todos los p�blicos
Estrella de fuego	#Elvis Presley, B�rbara Ed�n, Dolores del R�o, Steve Forrest	#Al Waxman.	#No recomendado a menores de 13 a�os
El esp�a que surgi� del fr�o	#Richard Burton, Oskar Werner, Anne Blake, Claire Bloom	#Abbas Kirostami	#No recomendado a menores de 13 a�os
El diablo dijo no	#Don Ameche, Gene Tierney, Charles Coburn, Laird Cregar	#Alan Grint	#Todos los p�blicos
Par�s, France	#Leslie Hope, Peter Outerbridge, Victor Ertmanis, Dan Lett, Raoul Trujillo, Patricia Ciccoritti.	#Albert Brooks.	#No recomendado a menores de 18 a�os
Ladybird, Ladybird.	#Crissy Rock, Vladimir Vega, Sandy Lavelle, Mauricio Venecas.	#Alan Parker.	#No recomendado a menores de 18 a�os
Callej�n sin salida	#Humphrey Bogart, Lizabeth Scott, Morris Carnovsky, Charles Cane.	#Abbas Kirostami	#Sin clasificar
Un d�a de boda 	#Desi  Arnaz  Jr., Carol Burnett, Mia Farrow, Geraldine Chaplin	#Alan Grint	#No recomendado a menores de 13 a�os
Un, Dos, Tres Al Escondite Ingl�s	#Patti Shepard, Judy Stephen, Tina Sainz.	#Alan Grint	#Todos los p�blicos
Otelo	#Orson Welles, Suzanne Cloutier, Robert Coote, Michael MacLiammoir. 	#Alan Parker.	#No recomendado a menores de 13 a�os
Dos veces mujer.	#Bibi Andersson, Sandrine Dumas, Anthony Perkins, Charles Gormley.	#Alan Parker.	#No recomendado a menores de 18 a�os
El esc�ndalo Larry Flint	#Woody Harrelson, Courtney Love, Edward Norton, James Cromwell.	#Alan Parker.	#No recomendado a menores de 18 a�os
Caf� Irland�s	#Colm Meaney, Tina Kelleguer, Ruth McCabe.	#Andr� de Toth	#No recomendado a menores de 13 a�os
Sabrina.	#Humphrey Bogart, Audrey Hepburn, William Holden, John Williams.	#Alan Grint	#Todos los p�blicos
Sangre f�cil.	#Frances McDormand, John Getz, Dan Hedaya, Deborah Newman.	#Abbas Kirostami	#No recomendado a menores de 18 a�os
Gary Cooper que estas en los cielos.	#Mercedes Samprieto, Jon Finch, Carmen Maura, Agust�n Gonzalez.	#Alan Parker.	#Sin clasificar
D�as contados.	#Carmelo G�mez, Ruth Gabriel, Candela Pe�a, Javier Bardem, Elvira M�nguez, Karra Elejalde.	#Alan Parker.	#Sin clasificar
Shakespeare in love (Shakespeare enamorado)	#GWYNETH PALTROW, JOSEPH FIENNES, GEOFFREY RUSH, 	#Alan Myerson.	#Todos los p�blicos
Babe: el cerdito en la ciudad.	#Magda Szubanski, James Cromwell, Mary Stein, ...	#Alan Grint	#Todos los p�blicos
Ciudadano Kane	#Orson Welles, Joseph Cotten, Dorothy Comingore, Agnes Moorehead	#Alan Parker.	#No recomendado a menores de 18 a�os
Un pueblo llamado Dante�s Peak	#Pierce Brosnan, Linda Hamilton y Jeremy Foley	#Barry Sonnenfeld.	#No recomendado a menores de 7 a�os
Do�a B�rbara	#Esther Goris, Jorge Perugorr�a, Ruth Gabriel.	#Alan Parker.	#No recomendado a menores de 13 a�os
Dos p�jaros a tiro.	#Mel Gibson, Goldie Hawn y David Carradine	#Alan Grint	#Todos los p�blicos
Tibur�n	#Roy Scheider, Robert Shaw y Richard Dreyfuss	#Abbas Kirostami	#No recomendado a menores de 13 a�os
Strike force	#Richard Gere, Cliff Gorman, Don Blakely, Joe Spinell	#Alan Parker.	#No recomendado a menores de 13 a�os
El d�a de la bestia	#Alex Angulo, Santiago Segura y Terele P�vez.	#Betty Kaplan.	#Sin clasificar
Chicago	#Tyrone Power, Aliced Faye, Don Ameche...	#Alan Parker.	#Todos los p�blicos
Satanik.	#Magda Konopka, Armando Calvo, Umberto Raho.	#Betty Kaplan.	#No recomendado a menores de 18 a�os
Un final muy feliz.	#Leaf Phoenix, John Aprea.	#Alex de la Iglesia.	#Sin clasificar
Terminator	#Arnold Schwarzenegger, Michael Biehn, Linda Hamilton	#Alan Birkinshaw.	#Sin clasificar
Fahrenheit 451	#Julie Christie, Oskar Werner, Anton Diffring	#Alan Birkinshaw.	#No recomendado a menores de 7 a�os
Nacido el 4 de julio.	#Tom Cruise, Kyra Sedgewich, Willem Dafoe.	#Billy Wilder.	#No recomendado a menores de 13 a�os
Habana	#Robert Redford, Lena Olin, Alan Arkin	#Alan Parker.	#No recomendado a menores de 7 a�os
Tar�ntula.	#John Agar, Leo G. Carrol.	#Alan Birkinshaw.	#Sin clasificar
Saturday night fever.	#John Travolta, Karen Lynn Gorney, Barry Miller, Joseph Cali, Paul Pape, Donna Pescow.	#Alex Cox.	#No recomendado a menores de 13 a�os
M�sica y l�grimas	#James Steward, June Allyson, Harry Morgan	#Alan Parker.	#Todos los p�blicos
Un yanqui en la corte del Rey Arturo	#Bring Crosby, Rhonda Fleming, William Bendix	#Alan Grint	#Todos los p�blicos
Missouri.	#Marlon Brandon, Jack Nicholson, Rendy Quaid,..	#Al Waxman.	#No recomendado a menores de 13 a�os